19 28
1 1 1 1 1 1 1 1 1 1 1 1 1 1 1 1 1 1 1 1 1 1 1 1 1 1 1 1
1 1 1 1 1 1 1 1 1 1 1 1 1 1 1 1 1 1 1 1 1 1 1 1 1 1 1 1
1 1 1 1 1 1 1 1 1 1 1 1 1 1 1 1 1 1 1 1 1 1 1 1 1 1 1 1
1 1 1 1 1 1 1 1 1 1 1 1 1 14 14 14 14 14 1 1 1 1 1 1 1 1 1 1
1 1 1 1 2 2 2 2 2 2 2 2 2 14 17 14 14 14 11 11 11 1 1 1 1 1 1 1
2 2 2 2 2 2 2 2 2 2 2 2 2 14 14 14 14 14 11 11 11 4 5 5 5 1 1 1
2 2 2 2 2 2 2 2 2 2 2 2 2 4 4 4 4 4 4 4 4 4 5 5 5 5 5 1
2 2 2 2 2 2 2 2 2 2 2 4 4 4 4 4 4 4 4 4 5 5 5 5 5 5 5 5
2 2 2 2 2 2 2 2 2 2 4 4 4 4 4 4 4 4 4 4 5 5 5 5 5 5 5 5
2 2 2 2 2 3 3 3 4 2 4 4 4 4 4 4 4 4 4 4 5 5 5 5 5 5 5 5
3 3 3 3 3 3 3 3 4 4 4 4 4 4 4 4 4 4 4 5 5 5 5 5 5 5 5 5
3 3 3 3 3 3 3 3 3 3 3 3 3 3 3 7 7 7 4 5 5 5 5 5 6 6 6 5
3 3 3 3 3 3 3 3 3 3 3 3 3 3 3 3 7 7 7 5 5 5 5 5 6 6 6 5
10 10 3 10 12 12 12 12 12 12 12 12 3 3 3 3 7 7 7 7 7 7 5 5 5 5 5 5
10 10 10 10 12 13 13 13 13 13 13 12 8 8 3 7 7 7 7 7 7 7 7 7 7 5 5 5
10 10 10 10 12 13 13 13 13 13 13 12 8 8 8 8 7 7 7 7 7 7 7 7 7 7 7 7
10 10 10 10 12 13 13 15 13 13 13 12 8 8 8 8 8 8 7 7 7 7 7 7 7 7 7 7
10 16 10 10 12 13 13 13 13 13 13 12 8 8 8 8 8 8 8 8 8 8 8 9 9 9 9 9
10 10 10 10 12 12 12 12 12 12 12 12 8 8 8 8 8 8 8 8 8 8 8 9 9 9 9 9






































